19 19 19 19 19 19 19 19 19 19 19 19 19 19 19 19 19 19 19 19 19 19 19 19 19 19 19 19 19 19 19 19 19 19 19 19 19 19 19 19 19 19 19 19 19 19 19 19 19 19 
19 19 19 19 19 19 19 19 19 19 19 19 19 19 19 19 19 19 19 19 19 19 19 19 19 19 19 19 19 19 19 19 19 19 19 19 19 19 19 19 19 19 19 19 19 19 19 19 19 19 
19 19 19 19 19 19 19 19 19 19 19 19 19 19 19 19 19 19 19 19 19 19 19 19 19 19 19 19 19 19 19 19 19 19 19 19 19 19 19 19 19 19 19 19 19 19 19 19 19 19 
19 19 19 19 19 19 19 19 19 19 19 19 19 19 19 19 19 19 19 19 19 19 19 19 19 19 19 19 19 19 19 19 19 19 19 19 19 19 19 28 26 26 26 26 29 19 19 19 19 19 
19 19 19 19 19 19 19 19 19 19 19 19 19 19 19 19 19 19 19 19 19 19 19 19 19 19 19 19 19 19 19 19 19 19 19 19 19 19 28 27 38 38 38 38 25 26 29 19 19 19 
19 19 19 19 19 19 19 19 19 19 19 19 19 19 19 19 19 19 19 19 19 19 19 19 19 19 19 19 19 19 19 19 19 19 19 19 19 28 27 2 2 2 2 2 2 2 23 19 19 19 
19 19 19 19 19 19 28 26 26 26 26 26 26 26 26 26 26 26 26 26 26 26 26 26 26 26 26 29 19 19 19 19 19 19 19 28 26 27 38 2 38 38 38 38 38 2 23 19 19 19 
19 19 19 19 28 26 27 38 38 38 32 32 32 32 32 12 10 10 10 10 10 10 10 10 10 10 13 23 19 19 19 19 19 28 26 27 38 38 38 2 38 20 21 21 22 2 25 29 19 19 
19 19 19 19 24 38 38 38 38 38 32 17 17 17 32 8 3 3 3 3 3 3 3 3 3 3 7 25 26 26 26 26 26 27 38 38 38 38 38 2 20 31 19 19 24 2 38 23 19 19 
19 19 28 26 27 38 38 38 38 38 32 17 36 17 32 8 3 4 5 5 5 5 5 5 6 3 7 38 38 38 38 38 38 38 38 38 38 38 38 2 23 19 19 19 24 2 38 23 19 19 
19 19 24 38 38 38 38 38 38 38 32 17 17 17 32 8 3 7 66 68 69 57 58 59 8 3 7 20 21 21 21 21 22 38 38 38 38 38 38 2 23 19 19 19 30 22 38 23 19 19 
19 19 24 38 1 1 1 1 1 38 32 17 17 17 32 8 3 7 70 71 72 60 61 62 8 3 7 25 26 26 26 26 27 38 38 38 38 38 38 2 23 19 19 19 19 24 38 23 19 19 
19 19 24 38 1 38 38 38 1 38 32 32 17 32 32 8 3 7 73 74 75 63 74 75 8 3 9 10 10 10 10 10 10 10 10 10 10 10 10 13 23 19 19 19 19 24 38 23 19 19 
19 19 24 38 1 38 38 38 1 2 2 2 2 38 38 8 3 9 10 10 10 10 10 10 11 3 3 3 3 3 3 3 3 3 3 3 3 3 3 20 31 19 19 19 19 24 38 23 19 19 
19 19 24 38 1 38 38 38 38 38 38 38 38 38 38 8 3 3 3 3 3 3 3 3 3 3 4 5 5 5 5 6 3 4 5 5 5 6 3 23 19 19 19 19 28 27 38 23 19 19 
19 19 24 38 1 38 38 38 1 1 1 1 1 1 38 14 5 5 6 3 4 5 5 5 5 5 15 38 38 38 38 8 3 7 38 38 38 8 3 23 19 19 19 19 24 38 38 23 19 19 
19 19 24 38 1 38 38 38 1 38 38 38 38 1 38 38 38 38 8 3 7 38 38 38 38 38 38 38 38 38 38 8 3 9 10 10 10 11 3 25 26 26 26 26 27 38 38 23 19 19 
19 19 24 38 1 1 1 1 1 38 38 38 38 1 38 38 38 38 8 3 7 38 38 38 38 38 38 38 38 38 38 8 3 3 3 3 3 3 3 38 38 38 38 38 38 38 38 23 19 19 
19 19 24 38 38 38 38 38 38 38 38 38 38 1 38 38 1 38 8 3 7 55 56 56 56 56 56 56 56 56 67 8 3 4 5 5 5 6 3 9 10 10 10 13 38 38 38 23 19 19 
19 19 24 38 38 38 38 38 38 38 38 38 38 1 38 38 1 38 8 3 7 78 38 38 38 38 38 38 38 38 79 8 3 7 38 38 38 8 3 3 3 3 3 7 38 38 38 23 19 19 
19 19 24 38 38 1 1 1 1 1 1 1 1 1 1 1 1 38 8 3 7 78 38 2 39 40 41 42 2 38 79 8 3 7 2 2 38 8 3 4 5 6 3 7 38 38 38 23 19 19 
19 19 24 38 38 1 38 38 38 38 38 38 38 1 38 38 1 38 8 3 7 78 38 2 43 44 45 46 2 38 79 8 3 7 38 2 38 8 3 7 38 8 3 7 38 38 38 23 19 19 
19 19 24 38 38 1 38 1 1 1 1 1 38 1 38 38 1 38 8 3 7 78 38 2 47 48 49 50 2 38 79 8 3 7 38 2 38 8 3 9 10 11 3 9 10 13 38 23 19 19 
19 19 24 38 38 1 38 1 38 38 38 1 38 1 38 38 38 38 11 3 7 78 38 2 51 52 53 54 2 38 79 8 3 7 38 2 38 8 3 3 3 3 3 3 3 7 38 23 19 19 
19 19 24 38 38 1 38 38 38 38 38 1 38 1 2 2 2 2 3 3 7 80 38 38 81 8 7 80 38 38 81 8 3 7 38 2 38 8 3 4 5 5 5 6 3 7 38 23 19 19 
19 19 24 38 38 1 1 1 1 1 1 1 38 38 38 38 38 38 6 3 7 82 83 83 84 8 7 82 83 83 84 8 3 7 38 2 38 8 3 7 2 2 2 8 3 7 38 23 19 19 
19 19 24 38 38 38 38 38 38 38 38 38 38 38 38 38 38 38 8 3 9 2 38 38 2 8 7 2 38 38 2 8 3 7 38 38 38 8 3 7 2 2 2 8 3 7 38 23 19 19 
19 19 24 38 38 38 38 38 38 38 38 38 38 38 38 38 38 38 8 3 3 9 10 10 10 11 9 10 10 10 10 11 3 9 10 10 10 11 3 9 10 10 10 11 3 7 38 23 19 19 
19 19 30 21 21 21 21 21 21 21 21 21 21 21 21 21 21 22 38 6 3 3 3 3 3 3 3 3 3 3 3 3 3 3 3 3 3 3 3 3 3 3 3 3 3 7 38 23 19 19 
19 19 19 19 19 19 19 19 19 19 19 19 19 19 19 19 19 24 38 2 2 5 5 5 5 5 5 5 5 5 5 6 3 4 5 5 5 6 3 4 5 5 5 5 5 15 38 23 19 19 
19 19 19 19 19 19 19 19 19 19 19 19 19 19 19 19 19 24 38 2 2 38 38 38 38 38 38 38 38 38 38 8 3 7 57 58 59 8 3 7 66 68 69 38 38 38 38 23 19 19 
19 19 19 19 19 19 28 26 26 26 26 26 26 26 29 19 19 24 38 2 38 38 38 38 38 2 38 38 2 38 38 8 3 7 60 61 62 8 3 7 70 71 72 38 38 38 38 23 19 19 
19 19 19 19 19 19 24 38 57 58 59 38 38 38 23 19 19 24 38 38 38 38 38 38 38 38 38 38 38 38 38 8 3 7 63 64 65 8 3 7 73 74 75 38 38 38 38 23 19 19 
19 19 19 19 19 19 24 38 60 61 62 38 38 38 23 19 19 24 38 38 38 2 38 38 66 68 69 38 38 2 38 8 3 7 38 11 9 11 3 9 10 11 9 13 38 38 38 23 19 19 
19 19 19 19 19 19 24 38 63 74 75 76 77 38 25 26 26 27 38 38 38 38 38 38 70 71 72 38 38 38 38 8 3 7 38 3 3 3 3 3 3 3 3 7 38 38 38 23 19 19 
19 19 28 26 26 26 27 38 8 3 7 38 38 38 38 38 38 38 38 2 38 38 38 38 73 74 75 38 38 38 38 8 3 7 38 5 5 6 3 4 5 5 5 15 38 38 38 23 19 19 
19 19 24 38 38 38 38 38 8 3 7 38 38 38 2 38 38 38 38 38 38 38 12 10 10 11 9 10 10 10 10 11 3 7 57 58 59 8 3 7 66 68 69 20 21 21 21 31 19 19 
19 19 24 38 38 38 38 38 8 3 7 38 38 38 38 38 38 2 38 38 38 38 8 3 3 3 3 3 3 3 3 3 3 7 60 61 62 8 3 7 70 71 72 23 19 19 19 19 19 19 
19 19 24 38 12 10 10 10 11 3 9 10 10 10 10 10 10 10 10 10 10 10 11 3 4 5 5 5 5 5 5 6 3 7 63 64 65 8 3 7 73 74 75 23 19 19 19 19 19 19 
19 19 24 38 8 3 3 3 3 3 3 3 3 3 3 3 3 3 3 3 3 3 3 3 7 38 38 38 38 38 38 8 3 7 38 11 9 11 3 9 10 11 9 23 19 19 19 19 19 19 
19 19 24 38 8 3 4 5 5 5 5 6 3 4 5 5 5 5 5 6 3 4 5 5 20 21 21 21 21 22 38 8 3 7 38 3 3 3 3 3 3 3 3 23 19 19 19 19 19 19 
19 19 24 38 8 3 7 20 21 21 22 8 3 7 38 1 38 38 38 8 3 7 38 38 23 1 1 1 1 24 38 8 3 7 38 5 5 5 5 5 5 6 3 23 19 19 19 19 19 19 
19 19 24 38 8 3 7 25 26 26 27 8 3 7 38 1 1 38 38 8 3 9 13 38 23 1 1 1 1 24 38 8 3 7 38 38 38 38 38 38 38 8 3 23 19 19 19 19 19 19 
19 19 24 38 8 3 9 10 10 10 10 11 3 7 38 38 1 38 38 8 3 3 9 13 23 21 21 21 21 24 38 8 3 9 10 10 10 10 10 10 10 11 3 23 19 19 19 19 19 19 
19 19 24 38 8 3 3 3 3 3 3 3 3 7 38 38 1 1 38 14 6 3 3 7 25 26 26 26 26 27 12 11 3 3 3 3 3 3 3 3 3 3 3 23 19 19 19 19 19 19 
19 19 24 38 14 5 5 5 5 5 5 5 5 15 38 38 38 38 38 38 14 6 3 9 10 10 10 10 10 10 11 3 3 4 5 5 5 20 21 21 21 21 21 31 19 19 19 19 19 19 
19 19 24 38 38 38 38 38 38 38 1 1 1 1 1 1 1 1 1 1 1 8 3 3 3 3 3 3 3 3 3 3 20 21 21 21 21 31 19 19 19 19 19 19 19 19 19 19 19 19 
19 19 30 21 21 21 21 21 21 21 21 21 21 21 21 21 21 21 21 21 21 21 21 21 21 21 22 5 5 5 5 5 23 19 19 19 19 19 19 19 19 19 19 19 19 19 19 19 19 19 
19 19 19 19 19 19 19 19 19 19 19 19 19 19 19 19 19 19 19 19 19 19 19 19 19 19 24 38 1 1 1 38 23 19 19 19 19 19 19 19 19 19 19 19 19 19 19 19 19 19 
19 19 19 19 19 19 19 19 19 19 19 19 19 19 19 19 19 19 19 19 19 19 19 19 19 19 24 38 38 38 38 38 23 19 19 19 19 19 19 19 19 19 19 19 19 19 19 19 19 19 
